{
	"levels": [{
			"difficulty": 0,
			"puzzles": [
				"007005001003010075085060000500030020031200004200680700000803900090100502610009040",
				"802903000007008600090005340600700804080020070051080000910800400403002006000040053",
				"209000300083024090000309800960070008400006070000140902090067000002000016007805009",
				"001800932040020100709100000000305826900082000086000005000050610070903000602000073",
				"430000610000609003090004200007000480005401906003060050001507004500840001300000028",
				"520000610000180204800960000000706001067048000082000370000609037714000000600070080",
				"206400000003081005000700209002000057170308090030002010080057000027090100900020570",
				"003008500100390006806000009065000020940700100000865003080016050000403092039000800",
				"804000007500600090000704805000040903093010020050306004000008740007900280682070000",
				"000510090008060007015204006027030500800002703006157200100009000700300040500700600",
				"530000040000805100001002030000240307802070000305900004000051209920304000057000083",
				"080090060049000805700051090008400006004730500601000340410003008060200900200008070",
				"800000104049008002500041000000500410005800960093007000007000826004380070680750000",
				"680050000000009015009084070960007400000100052200803006090000580507300004002910300",
				"500004030069050042804009070200300500050010004007002308030400006090005480040960000",
				"004002000300000209002035070080900740900003508007250000000020000176000952020761080",
				"600720040004000538009083000000500862035096000207000090010300600040608003370000100",
				"030005010070480060009300200001000572000510006358006000900150700200004090400000358",
				"000004700803001200500060080000010048104050900030092001409183607700000030080600002",
				"835000070400105000000040509008960001020007600070004090009700380500090017016038000"
			]
		},
		{
			"difficulty": 1,
			"puzzles": [
				"006800040070009082300002000082100003030020100000050408600004500204000061800960070",
				"019200000000043007000010480047006028020004100500008040008470001100060030002800600",
				"706800040000090510090040006100004700005760000402000360000206034020008009084001000",
				"082000050000040602160075000040000069500906000900082070057100080000020407004700900",
				"009180700000902010005700006300029000720000030000007800106290007900003001030010905",
				"070040520052010043000205006300080600800100009001009000209001070080000904700304000",
				"724090800009050010000007206007000104800200000090500062000040008070005940100620005",
				"100020007503000900000403081060090430805200100090800002080700010002019000009000270",
				"000000205017800000080090010009084070800001509602009040090600700308100600000040108",
				"300040800001020095620300000000008704017002080080030009094200000700000941000419000",
				"000940080030200401104030000008400700410306090600002008020000600000027009001803050",
				"057000008001000904600287000000002840503010200200360000000020085760000039080403000",
				"300091600010008007060000910036070100007800090000300720000147009740900000005000204",
				"300280040806010007400030520530000100000903052060008000075000900000002805008305000",
				"000005037042060000500407000020049080004000029001820003400002500015004900060100300",
				"004030900960100050030002070000840509841005000005010004706000000000080037400006105",
				"805700000000000710070603000004020861690001000008370400900100080000035047010080030",
				"960008200000001830008600001000800604803005009020019000080730000400050068309000040",
				"002006108300470000014000700090080460000160080036700900000340020609000004700002005",
				"000902060060510009290000100030080204075009600000760001001607000386000510400001090",
				"050049006009002300800006001008010002200070080070060400600394000902800600380000010",
				"000527000607000080050080010200100300810700000003090801090600150100009004005014002",
				"000900530270308000630000002004009005008700029003080000000090258050010600306050900",
				"200001008680035000034000901020307000007002840400000520500700030006050004900080700",
				"006200005000063009009000670800407900390000507600002080008005002020600430070820000",
				"050000703009306000070008200005100002002490070100020039500009000000050386760080050",
				"070009006020060010001204050003800100806350900007090030600048000100602004040000800",
				"020300004900008007006040850010009308000704010395001000080090700001060040600400080",
				"500090006060300001104000500200700008006002090403060050041005003020003170000610400",
				"002000340160030000000280010009002035040000209205006000000100703400003620058600100",
				"070003200020007050003800400001300020500000760086015000000950002810004009400038005",
				"010050070940060000000030041002100000000003067407600800601590000050007602004006150",
				"080009010200070083016030200000020830037040090800500000905007000600300900000902071",
				"501090000030802050000500834010009706090001300300200500008070015000008007106020000",
				"000803200800020006409500070040601300500400009006000701090002057002060030010045000",
				"000104009106050400008009010510000804070020091000040300900007508600015040005400000",
				"590006080200900004000010900603107400000004176107000000070080005010720000002300740",
				"041002000000108042200000507000050408002410000370006000703000050000620804020305070",
				"000062085026007000003004002300010207010000800070850001700600940009000020200095070",
				"700900038000500006008020900350800000020010003400005027619074000000003410003100700",
				"700005009000600740602007000020000304040570800001900007009001038010039070403080000"
			]
		},
		{
			"difficulty": 2,
			"puzzles": [
				"501200004006940000000017260030001005000050040150000600063000402009700000200008000",
				"000001920008009007200300001000000760100900030062500090006040800400290003350000000",
				"800019070001200000067003000000490600386000010000068007170000008040000060000507300",
				"700000480000106900050030000000209004074000000003010052090000508007820006820001000",
				"007000250090008600003026010940080000000900085500010009000200140000500006701004000",
				"750000806006500090400368000061000000000019300000200070070005040000690005905000002",
				"024019600000000058070300900030050000000007810100200000900400006600028009003060040",
				"470060000030900004009380600700090040008005000090100002014000700000009080500070309",
				"090700100007500090801009020000030009430006000080002074000200500518000200200000030",
				"076100003000003260030020000704900000000400006600005091400050630800007000090030070",
				"000090015002800000180000240070500001500006004001003000700204000006050030018030700",
				"000096070470500000000002850609000003000801900280030000090627000000000016067000500",
				"000040006600000002700900380020004100003050600058009040204008030007090000000705004",
				"060004100074050000000090040200380001800002050000007420000100803006000507750800000",
				"090010006001200300000000070009602000000070402700004190200501003906000057003700000",
				"600200000000000473001070006070005860408000500000180090080090042060000305004008000",
				"100602000904000068070008900007250000000000730010000209400007500030000806009084000",
				"900008000000090360600000900000580007016004000502060004020400730093200500060003000",
				"600070502094008007000900030500000900006500470000007008067049000000000701481000000",
				"108600050000050470002001030095000008800400007000085600019000300000369000700000002",
				"009000108005902030003080002002004060090800420410600000200043000000010200070000800",
				"100000504500006009030018000000005910080060070010400000006900040007200601000630005",
				"800390000060010200400000530900003100530007000006900040014006000080050007009000086",
				"000002001050040006400800500600370010703060000095000670000700800060004005080009400",
				"007000035050034000000009002600020740040300000030401006009000820003040001800906000",
				"019070000000050670200010409000604025160000000002037000096000008020000700000308040",
				"000900014000006500295000000034060009600093000050700030008070900501000600000800140",
				"000170020250000047001400500062000700300001000000206009706004000000090470100050008",
				"008000107700000602090260000150006040000501020006000570000180000040009010009000403",
				"726800009000200080000003006000006205000000960690070000050000804002380050400001600",
				"000086500020900006003000001030050010006014050800070200010400000000000185602100030",
				"105200007000430090003050800052000000000000003000149080090300070200010900704002100",
				"000000700000005009205000300340076000020000041001840007050003000600900528104050000",
				"069400000001080500000900620350004000002500700000062005140000060000801007080005010",
				"001200080000010009058003001180400500000006910040700200400000030800004007300060090",
				"004000007050082000060700040090001700500300001008007050601040000000070410200500903",
				"008300700300002000042000030000050008207000015000026400170000804050004001400860000",
				"000000803000502190960000000708006050050091000002008070800040000049000710600900002",
				"030600009000050740257000000900200071400061000100400208010903000000020000002100300",
				"900000670000702900250010040048000007000830001001007800009000050000900106830006000",
				"630020900090700006001400000040001207500630001010000030000000020008916000063000080",
				"000700001000080095340509000004002050090008006200900400006001500002050060100020030",
				"900570006000308500003000007040007050705094000000050100359000000000060080006705009",
				"075000036400000050000250000080070900500340100901000000104005000038002010000008309",
				"008060500590000000000080014005106040960700805007000090000200006619004000000070030",
				"006043000008500090003000740060002009090070800010600005001008002600700080200001600",
				"000903020740000500630500000050000004403290001000008200590000060000010370007050400",
				"400000053206050010000091006000940800349000000005600009030502000000000730100004002",
				"000783000080000001007900530006001000000068100150400080040000002720630040000800300",
				"800300004500420060000001002020580700043000080000047000000050190000094800901000007",
				"610000004004600050002304009073008000100043000000000408040061090000030020030200100",
				"903200000070400500400001030017000053000050080002703000030002800600070009040800300",
				"000740003094008010000300004005000300010000820900850600100000036800007090002003100",
				"600400009300010000010209080008000403900000100001508002060000205003007040000950600",
				"090000020500600700760801300005086000800000107009400080000000053081093000000008400",
				"030814000001000007009000004590008000006005943007001500000930200000080060620000009"
			]
		},
		{
			"difficulty": 3,
			"puzzles": [
				"801000030070490000000800100294000006000000920000005007000002004040060008500700600",
				"010000005000763000003008002800300100000001000570900000002040038196000000000070050",
				"000680000000004070901000020000030601600001000058000400075108000010020005800000700",
				"030000108400000000000500090000380500600000040050400076380000004001028007007900000",
				"080250000060080003500000020000009307059000080003000000690700000000003701000028006",
				"830000702500006080047800000000060490700100000019000300000900000050000006000081003",
				"052300600400801000000006840040005003075000000600070010000100002000000406009030000",
				"070000605200600000000105000000076080060020009004000730109000800000084090000500007",
				"500001000000830000041000060000027140000900000020000005080005200007002053900060007",
				"019000000840003005000008002000400070050060100700500020000040600007900000483200000",
				"200003100040700009030069000300000010400000580005040200000207000000001305009000008",
				"300100500040700000008000047090036000400050008003000020050900680000002004080007000",
				"001007006006000040200190000670000050010070000300208004000001900000700200085000030",
				"009000036300072000070005008000800400003410060010000005004000670000004150900000000",
				"090300008007000000040000760702080040080000020000062100000507009000090800950000006",
				"080005600009000003700009080000024010090000000001000502010000060300270001602040000",
				"000030060007100000005700304200473000810000000000010050004005009060000200090000043",
				"000040007002000600510003004050000300607900000004080010900007000005002030000100206",
				"009008071050060000004005000016020380000080007340100002000000600200370090000000000",
				"000025003800000070290007010000480100000030002428000000039000000060018000000900007",
				"900804000001500003007000010000020830409600000050040002008000700500006000010050300",
				"006004350000300400009080000900830007000000010520000000007000100015076030000400002",
				"090000240200030000005060800602403001000900084000100000000000730006015000000007008",
				"300002001000000500940300000083000000700905020200081003006020400050000900000106000",
				"200090004000030080730060000002001070409300000000008109000005710086000500000600000",
				"008900730000003000050048000000030840600200100003060000200007008500600000000000952",
				"000007059040900602900080004000000800062000000509000207000004060710030000000000105",
				"007900020040000006000081000002700004008090007070008060000109030601000200350000000",
				"000004090001500030070000048800009010000010080057000000000037800060040009082000600",
				"006007000008090030400000100060000920009580001500100000030000204000470000100008060",
				"009700800760300000000500300005000000000030049801092000003200006000061000910000050",
				"800070009630000500005020030000052008081000090020000700710000000000003040003010020",
				"060000070500009000400720900070308000004002005008000067000000180000030600290040000",
				"000082007005000300007900000300600020060005940000040000090073005400200060050000009",
				"600085000004900005300000960009001020070000090000006001403100006000002003000800500",
				"000080004000000050003001000040060000000000206670500000009070402580900100004600930",
				"000020000008070040030100005804000630000814000002000100620000000000036200700009800",
				"100360007003020000020000004300000200010900008000705090630008000200010800007000050",
				"016700000000090508092000100060900007400085001005000030030070000000060000000004360",
				"000050006850000900020400000100035070000000009002600000060010090000074020003002701",
				"000400035091000600300020100005008090200070000003900050000002001100000008060005004",
				"020040300003000000000010402040800630000700001009006800008500000205030000000008075",
				"000500090100000030007060000305000004060018000000000069000000407051002300204630000",
				"062800000000070000500009034000726000200000100000008409170900300029000000000007040",
				"090075000100000002030000010070002090008900703001000500200600001000090830400050000",
				"010000003000500070205060000004008060009040100820000400030200001000301050000900300",
				"000004005000060308008500000000400107063050020010006000004700000600100250800090000",
				"000900730205000000003008040070509006000000100800000090080600004006040008040010900",
				"000050009015620000000000071001802400060007008030100700400000000000040680026000000",
				"007000805000000001000620000005009004063000000008010900010030002500901030040000150",
				"000800407030069000500000200000057000095000004007030020000008610020300000900700002",
				"080090007700050001410000080692000000004001000000020300000200500000700060370009400",
				"060000490900030000002001000005006030109000002080000159450700900036000000000080000",
				"003010060520000100000004039007000203000602000081005000368000010000800000010090000",
				"570600080000700309906040000000030150037009000800000090000217000080000000005000040",
				"507000000000208060060400000081009005000005002450030800003020007000001903070000000",
				"006100004000036800100000009001005086300010000029800000200000005000528000070000400",
				"007080200030000001080169000070000090000402000800006007010030900205000000000000148",
				"007009080910080000080700002020800010090000060300090000004001700000204300000600400",
				"680009020009006080000400901500060000000037000000000703400018000000900000906000042",
				"401900000030007400070001069000690050300000000002000007050802000000010206600000010",
				"840050700100000005007006009600720000070000008000300070000084000039000020005900100",
				"000008020000070000401000003000600005060209000082000001090047000008002040003000592",
				"043009000005700090800040002006003100900200003080000006500030800000100070000402000",
				"002083400010000000004010052090160020700800000000002603070000004000000500800904000",
				"200000070030490006001005000100050400020070005073000061800006000000083000006000050",
				"000000050086700000002084030140003000000000000070090408000001006538900000000040520",
				"006000018000040003007630000040700000000009820081000009920000030000007900500400100",
				"900027000000000300100000900090850000004000089030600005340000050000038000002104007",
				"000010400000903000050004006010090000096000000700850009000009140400000670800702000"
			]
		},
		{
			"difficulty": 4,
			"puzzles": []
		}
	]
}